                              +----+      
                              |....|      
                              |....########
                              |....|      #
                              +-#--+      #
                                #         #
                    +--+        #         #
  ###################..##########         #
  #                 |..|        #         #
  #                 +--+        #         #
  #                      +------#-----+   #
  #                      |............|   #
  #    +---------+       |............#####
  #    |.........|       |............|   #
  #    |.........|  ######............#####
  ######.........|  #    |............|   #
       |.........####    |............#####
       |.........|       |............|    
       +---#-----+       +------#-----+   
           #                    ###       
           #                      #       
           #                   ####       
   #########                   #          
   #             +---+         ########   
   #             |...|                #   
   #        ######...|                #   
+--#--+     #    |...|   ##############   
|.....|     #    |...|   #                
|.....#######    |...|   #                
|.....|          |...+---#--+             
+-----+          |..........|             
                 +----------+             